++++++++++++++++
+    ++++++    +
+ ++         +++
++            ++
+              +
+              +
+              +
+     ++++     +
+     +  ++    +
+          +   +
+           +  +
+        +   + +
+    +++++     +
+              +
+         +++  +
++++++++++++++++
