++++++++++++++++
+    ++++++    +
+ ++         +++
++            ++
+              +
+              +
+              +
+     ++++     +
+              +
+              +
+              +
+              +
+    +++++     +
+              +
+         +++  +
++++++++++++++++
